bhhhhhhhhhhhhhhhhhhb
vl                 v
v  bhhhhb   bhhhb  v
v  v            v  v
v  v            v  v
v  v  p         v  v
v  v            v  v
v  v        e   v 2v
v  v            v  v
v  v            v  v
v  v            v  v
v  v            v  v
v  bhhhhhhhhhhhhb  v
v  1              cv
bhhhhhhhhhhhhhhhhhhb