bhhhhhhhhhhhhhhhhhhb
vl                 v
v  bhhhhb   bhhhb  v
v  v            v  v
v  v            v  v
v  v  p         v  v
v  v            v  v
v  v        e   v  v
v  v            v  v
v  v            v  v
v  v            v  v
v  v            v  v
v  bhhhhhhhhhhhhb  v
v                  v
bhhhhhhhhhhhhhhhhhhb