hhhhhhhhhhhhhhhhhhhh
v                  v
v           e      v
v                  v
vhhhhhhb           v
v      p           v
v      v           v
v      v           v
vhhhhhhb           v
v                  v
v                  v
vhhhhhhhhhhhb      v
v c                v
v                  v
hhhhhhhhhhhhhhhhhhhh