hhhhhhhhhhhhhhhhhhhh
v                  v
vbb    b b    hhhhhv
v     b    b       v
v     b p  b       v
v     b   b        v
v     b   b        v
v      bbb       e v
v           hhhhhhhv
v   b              v
v   v    b         v
v   v    v         v
v   v    v         v
v   v    v       c v
hhhhhhhhhhhhhhhhhhhh